....##............##.............###...#
.....##........#....#.....#.........#...
#........##.........#........#...#......
...##......#.........#........#........#
.........#.......##....................#
#.#.......#..............#........#.....
##............##.............###....#...
#....##........####........##..#........
.........###.......#.......#..#.........
#.............#......##.....#.....###...
.......#....##.....@.#.#......##......#.
###...............###...###..........#..
.......................................#
#.#..#.........#..#........##...........
##....#..........#...............#......
#......#........#....#....#.........###.
......###..........##..........#....#...
##.........##.............#.........#...
..............#........#...#............
....###........#..........##............
.........##......##.........##.......#..
####....#....#.....###.....##......####.
...##........###...............##....#..
#........##...........#.........#.......
###.........###..................#......
#........#........##..#......###......#.
#......##.........#......#.............#
...###.........##............#....#.....
......##............#....#......#..#....
##..........##.......#...#......#.....#.
###...........##..........#........#....
#...........###.......##.....###........
.........#...........#............#.....
......##......#.............#......#....
.#......#......##..............#......#.
#..........###.......###.............#..
##.....####..................#...#......
..........##......##....##.............#
...####..........##.....##.......#.....#
#.............##........#.......#...#...



