#####......####..#.....####..#..##.#...#
#....#...###....######....#.........####
##..........##...###....###...........##
.......#.....##....#....#........####...
.#....#...#..###.....#.....###..#.....#.
###.........#.......#....####....##.....
##..#...#..##.......#....#.............#
#..............#..#...######............
#.....#.....#....#.#.............###....
...###........#..#.....######......#...#
#......#.........#.........#....##......
#..........##...##....##........#.......
.###.#....####.......##..###...##....###
.#...##.....####...........####..#..#.##
....##............####..#.........##....
...#.......####.....###...#...#####...#.
............#..#.#......#.##....##......
...#......###.........#..#....#..#.##...
..#.....#.....#...##...#....#........#..
..####........##..............####..#.##
....##...##...#......###..##.#......#...
....##......###...#.......#..#.....####.
....###.#.......####...........####.....
...#....#######......###..........#...#.
#.........................#..#....#..#.#
......###...........#....##.........#...
#..........########.............##....#.
####....#............####........#..#..#
##......#..##.....####.###..#...#####...
.#.#...###......##............#..#...#..
.#..#...#......#####............#..#@#..
###..###......###.........#.......#.##.#
....#........#..#...#...##..#...#.....#.
#..........#..##.#...###......#.........
###.#..####....#....#.#.......##.......#
.#...#...........###...........##....#..
...#.#.......#...##..........##.......#.
#..##......#.....#.......##.....#.....#.
#.#....###...........####........####...
...##.....................#.........#.##