##.............#........###............#
#.........##...........#...........#..##
.......###..##..............#......#...#
..#..........#.......#.......#......###.
.#.#....#......#.........#...#.........#
..............#..##..........##...#.....
.........###..#.........#.........#.....
##.....#..................#...#...##...#
.............#....#.....##.......#.....#
....#............#...........#..........
....#....#......#....#.......##.....#..#
...#.......#.......#####............#..#
......#...#....#..............#........#
#.....#.......#.......##...#....##.....#
.......###.......#.....................#
.....#...........#.....#....#...........
..#......#.......#@.......#.#......##...
...###.........######............###...#
....................#.....#.#..........#
......##.....#......#..........#........
..#.................#.................#.
............#.....##.........#.........#
.............#..............##.....##...
######.......#.#.......##.....##........
.....#..........#....##.....#....#....#.
#....#.....#............##.............#
#.......#.......##.........#.....#.....#
#..........#.........#....#...........##
.........##.........#...........#......#
.............#.........#...##..#....#...
####..........#..............##.........
..........#...#...##..........#....#....
#...................#........#.......#..
.......#.....#......#.......#...#......#
.#####....##.........####.......##....##