###.....####.......##.......####.....###
.........##..................##....#...
.#...#...........#....#...............#.
.#.......#............................#.
...#...........#....#...#........#..#...
...#........................#.......#...
......#......#.........#..#......#......
......#..........................#......
...........#.....#....#.....#...........
....#.......#...#......#...#.......#....
....#....#...###........###...#....#....
..#.............#....#...............#..
..#....#................#........#....#.
.#.........#.#......#.....#.#.........#.
#....#......#..............#......#....#
.....#.....#.#....#..#....#.#.....#.....
.....#.............##...#.........#.....
#........#.........##..........#.......#
.....#............#..#............#.....
.....#.....#.#............#.#.....#.....
#....#......#......#........#......#....
.#.........#.#....#..#.....#.#.........#
..#....#........................#....#..
..#..........@.....#.................#..
....#....#...###........###...#....#....
....#.......#...#......#...#.......#....
...........#.....#....#.....#...........
......#..........................#......
......#...#..#............#......#......
...#................#...............#...
...#...........#........#....#......#...
.#.......#......................#.....#.
.#...............#....#...............#.
.........##..................##.........
###.....####.......##.......####.....###
