#........#...........#...................#
.#............#....#....#........###......
..#...##.....#............#........#....#.
...#..........###...#.......#..........##.
....#....................#...........#....
...........###..........##..#.....##......
..#........##.....##.....###..#...........
......#.....#....#.....#..@#............##
............#....#......###..............#
....#....###..............###.....#.......
..#................#.............#.......#
...#........#........######...............
.............##.....#......#..........#...
.#......###.....#....##..#......###....#..
......#.....#...#....#..#..#......#...##..
#....#.......#.#....#....#..#....#...#....
##..#....###.....#.....#..##..#......#....
###.#.........#......#....#.......#.......
##..#.........#.......####.....#..........
#.......#.....#........##.....#......###..
....##...#...#.##................#........
...#..#....#......##.....###..........##..
....#.....#......#......###....#........#.
.....#...#....#....##.........#...#.......
#.....###........................#...##...
.#...#........#..........##......#........
....#.....######.....#....#...............
...#.........###...#........#........#....
..#....###....##...###.#.....#.....#....#.
.#....###....#..#...#.....#....#...#......
#........#......#......#.......#..........
#.........#....#....#...#......#.....#....
#....###......####..........##............
#......#........#.......#........#......#.
......#.....#...#....#..#..#......#...##..