###.........#.....###.........#......###
#.........................#............#
#....#.................................#
............#.....#.#.......#....#......
................##...##.................
#..............#.......#................
......#....##.##.......##.##.....#....#.
..........#..#...........#..#...........
...#.....#....#..#@#.#..#....#..........
.........#........#.#........#.........#
..........#.................#...#.......
.#.......#..#.............#..#..........
.........#.....#.#...#.#.....#......#...
.....#....#...##.......##...#...........
...........###.#.......#.###...#........
#...............#.....#................#
#...#..........#...#...#......#........#
##............##..###..##.............##
#..........#...#...#...#...........#...#
#......#........#.....#................#
...........###.#.......#.###............
#.........#...##.......##...#..........#
.......#.#.....#.#...#.#.....#...#......
.........#..#.............#..#..........
..#.......#.................#...........
.......#.#........#.#........#.......#..
.........#....#..#.#.#..#....#..........
#.........#..#...........#..#...........
.....#.....##.##.......##.##.......#....
#..............#.......#.....#.........#
.............#..##...##.................
.......#..........#.#...........#.......
#...........................#..........#
#.........#............................#
###...............###.........#......###



