#....#.####.......##..#.........#.......
####........####.....##.........#.......
#....#.......##.....#...........#...##..
#.....#........#............#..#.......#
###......###.#.....#.##............##..#
##..........##.......#.#...........#....
###......###........#.#..#.....#...#....
#...#..###.........###..#..#......#....#
.....##...........#........##.....#.....
#.....#........##....#@#.......#...####.
....#.......####.....###...#...#####...#
.....#..##.....####...........##.....#..
..###........#..#.....####.#......#.....
#.......##.......#..#....#.#............
..#.#...###..........#..................
.##...###....###...........#.......#....
.........#..#...#.....#..#...#.....#....
.........#..#.#........#.#.............#
###......####..#.......####..#.#..#...#.
......##..#.#............#......#.......
.....#...#...###..#...##.............###
###....#.#................#....#........
.....#..#...###..#.....#.........#.#....
.........###.....#.....###....#.........
..##....#...#................#.........#
....##.......#.............##...........
...#.....###........#.###...........####
#.............#...#####....#........##..
.......##.......#...#.........##.....#..
........###......#..#..#.....####..#....
......####......#######..........#..#.#.
#........................###.#..####....
..###.#....####...........###...#.......
...##..##...#..........#..#..#......#...
.....#...#....#.....##.........#...#...#














