########.......##....##......###........
....###.............##............##....
......##.........###.....#####..........
..............#.........##..............
#...................#...........##.....#
##........##...................##....###
###.......###.......######..............
##.......###.#......##......#.#....##...
..................#####.................
...#...######.............. .....#..####
............................###.###.....
....######.......#....####.......##..###
.#...##.....####...........####..#......
.......................#.........#......
.#..........##.......#@....#....##..##..
.....#...###.....#....##......##........
......######...................#........
..####......##...................#.##...
.........##.......###.....#........##...
...##.......##..........................
#........##.#.......####........##......
....##...##...#......###..##.#......#...
.......###...##............#..#......###
....####........#.............###.......
..###...............#.......#...........
######........#................##.....#.
.###......#...##.....####...............
..#...........##.......###.......######.
......#......####.................##...#
##............#...........#.............
##..........###.......######............
...##.......#...............##.........#
..##........###.......######......#..###
...##.............................#...##
.................##....................#
#........#.....######....#......#..#...#