
#.........................#............#
...#.....#....#..#.#.#..#....#..........
...##........###.#.......#.###..........
..........#.................#...#.......
.............#..##...##.................
#..............#.......#.....#.........#
#....#.................................#
.........#........#.#........#.........#
.#.......#..#.............#..#..........
#..........#...#...#...#...........#...#
.........#...........#............#.....
.......#.....#.#...#.#.....#.......#....
#.........#...##.......##...#..........#
....#.....##..##.....#....#.............
###...............###.........#......###
................##...##.................
#..............#.......#................
.......#..........#.#...........#.......
#...........................#..........#
......#.....#...#....#..#..#......#...##
##..........##.......#...#......#.....#.
.......#.#.....#.#...#.#.....#...#......
#...#..........#...#...#......#........#
.........#..#.............#..#.....#....
##............##..###..##.............##
#......#........#.....#................#
..#.......#....#.............#....##....
.......#.#........#@#........#.......#..
.........#....#..#.#.#..#....#.....#....
#.........#..#...........#..#...........
............#.....#.#.......#....#......
.....#....#...##.......##...#...........
#...............#.....#................#
...........###.#...#...#.###...#........
#.........#............................#
.....#.....##.##.......##.##.......#....
###.........#.....###.........#......###
......#....##.##.......##.##.....#....#.
..........#..#...........#..#...........
......##............#....#......#..#....

