#####......####..#.....####..#......####
##..........##...###....###...........##
##.....#.....##....#....#........####...
###...........####........####........##
###.........#.......#....#.......##.....
#.....#.....#...##...#....#........#....
........#..#.......####......###.#.####.
.#......#.##............####.......#.#..
.........#....###......###........#.#..#
.....#...#....#...#..###.........###..#.
.#......#....#.....##......#.....#......
.##.....#.....#.....#........##....#.#..
.....#...####.....#.......####.....###..
.#...#####...#.....#..##.....####.......
....##.......#...#....#.....##.........#
...#......#....###........#..#.....#####
#......#.....#.......##.......#..#....##
#........................##....#...#...#
####....#.......##...#..........#..#..#.
##.#...###..........#........#..#...#...
##..#...#.....#.............#..#.#......
#.................####...........####..#
##..#...#.........#....#.............##.
##.#............###....#.........###.#..
####....#....#...#...###@.#...#####....#
#..............#..#...######............
#.....#.....#....#.#.............###....
#......#.........#.........#....##......
#.............##....##........#.......##
.###.#....####.......##..###...##....###
.#...#####....#........##............###
....##.......#...#.........##.....####..
...#......###.........#..#....#..#.##...
..#........#.....###.....##....#..#..#..
...#.#...###....######........##........




