#....#.......#.#....#....#..#....#...#..
##..#....###.....#.....#..##..#......#..
###.#.........#......#....#.......#.....
###...............###...###..........#..
##..#.........#..#........##............
##....#..........#...............#......
.....##........#....#.....#.........#...
##............##.............###....#...
...#........#........######.............
.............##.....#......#..........#.
##.........##.............#........@#...
####....#....#.....###.....##......####.
...##........###...............##....#..
#........##...........#.........#.......
#........##.........#........#...#......
...##......#.........#........#........#
.........#.......##....................#
#.#.......#..@...........#........#.....
###.........###..................#......
#........#........##..#......###......#.
#......##.........#......#.............#
...###.........##............#....#.....
###...........##..........#........#....
#...........###.......##.....###........
......##............#....#......#..#....
##..........##.......#...#......#.....#.
.........#...........#............#.....
....#.....######.....#....#.............
...#.........###...#........#........#..
..#....###....##...###.#.....#.....#....
.#....###....#..#...#.....#....#...#....
.#......###.....#....##..#......###....#
......#.....#...#....#..#..#......#...##
....##............##.............###...#
#......#........#....#....#.........###.
......###..........##..........#....#...
#........#......#......#.......#........
#.........#....#....#...#......#.....#..
...####..........##.....##.......#.....#
#.............##........#.......#...#...



