#.###.#.#.#.#.#.#.#.#.#.#############.#.#
...#....................#...#.......#....
#................#.......#.........#....#
........###...............###...###......
#......#####............................#
........###....#.......#############..###
#...................###.................#
.....#............###.##...#.........#...
#.........#.....###....####.............#
.............###...#...........###.......
#.........###...#.............#####.....#
...#....###...#..#......#.....#####....##
#......#..........#...........#####.....#
......#....#.......#.....#.....###.......
#..................#.................#..#
....#...........#..#.......##............
#..#...............#......####..........#
..#.#....#.........#......####.....#.....
#.#..#.........#..#........##...........#
##....#..........#...............#.......
#......#........#....#....#.........###..
#........................###.......#...#.
#..........###..##........#.......#...#.#
......###.#.......#...............#.....#
#....#...#.........#...#.#....#...#.....#
##...#..#...........#.#...#..........#@#.
##.....#.......#.....#.....#........###..
##....#...................#......#.......
#....#....#............###..............#
.....#.................#......#.....#....
#....#...........#.....#.....###........#
.....#.................#......#..........
#....#.......#......#..#............#####
.....#..#..............##.......#..#....#
#....#.................###..............#
......#....#..........###........#..#...#
###....#.........#...#.......#...#......#
####....#...........#............#....#.#
#####....#...#.....#.....###.....#......#
#####.#.#.#.###.#.#.#.#.#####.#..##.#.#.#
